21 21 4
#####################
#1 %%%%%%%%%%%%%%% 3#
# #%##%#%##%#%##%## #
#%%%%%%%%%%%%%%%%%%%#
#%#%##%%%%%%%%##%##%#
#%%%%%%%#%%%#%%%%%%%#
#%#%##%#%#%#%#%#%##%#
#%%%%%%%%%%%%%%%%%%%#
#%#%##%###%###%#%##%#
#%%%%%%%%%%%%%%%%%%%#
#%#%##%%%%#%%%%#%##%#
#%%%%%%%%%%%%%%%%%%%#
#%#%##%#%%%%%#%#%##%#
#%%%%%%%#####%%%%%%%#
#%#%##%%%%%%%%##%##%#
#%%%%%%%%%%%%%%%%%%%#
#%#%##%#%##%#%##%##%#
#%%%%%%%%%%%%%%%%%%%#
# #%##%#%##%#%##%## #
#4 %%%%%%%%%%%%%%% 2#
#####################

' '= espace= case vide
% = mur destructible
# = mur indestructible
1; 2; 3; 4 = joueurs