21 21 4
#####################
#%%%%%#%%%%%%%#%%%%%#
#%#%%%%%%%#%%%%%%%#%#
#%%%%%##%%%%%##%%%%%#
#%%%#%%%%%#%%%%%#%%%#
#%%%%%%%#%%%#%%%%%%%#
#%#%%%#%%%#%%%#%%%#%#
#%#%%%%#%%#%%#%%%%#%#
#%%%%#%%# # #%%#%%%%#
#%%%%%%% 1#2 %%%%%%%#
#%###%#########%###%#
#%%%%%%% 4#3 %%%%%%%#
#%%%%#%%# # #%%%%%%%#
#%#%%%%#%%#%%#%%%%#%#
#%#%%%#%%%#%%%#%%%#%#
#%%%%%%%#%%%#%%%%%%%#
#%%%#%%%%%#%%%%%#%%%#
#%%%%%##%%%%%##%%%%%#
#%#%%%%%%%#%%%%%%%#%#
#%%%%%#%%%%%%%#%%%%%#
#####################

' '= espace= case vide
% = mur destructible
# = mur indestructible
1; 2; 3; 4 = joueurs